NO ./textures/arbre_north.xpm
SO ./textures/arbre_south.xpm
WE ./textures/arbre_west_2.xpm
EA ./textures/arbre_east_2.xpm
C 0,255,222
F 175,225,14



        1111111111111111111111111
        1000000000110000000000001
        1011000001110000000000001
        1001000000000000000000001
111111111011000001110000000000001
100000000011000001110211111111111
111101111111110111000W0010001
11110111111111011101010000001
11000000110101011100000010001
10000000000000001100000010001
10000000000000001101010010001
11000001110101011111011110001
11110111 1110101 101111010001
11112111 1111111 111111111111
