1111111111111111111
111111P011111111111
1111110011111001111
1000000000000000001
1000000C00000000001
1000000000000000001
1000111111100000001
1000000000000000001
111111C111111E11111
1111111111111111111
