NO ./textures/wall_north.png
SO ./textures/wall_south.png
WE ./textures/wall_west.png
EA ./textures/wall_east.png
F 175,225,14
C 0,255,255


111111111111111111
110000001101010111
100000111111000001
100E0000000000011
110000011101010         111
11110111111010101
11111111111111111
