NO ./textures/wall_north.png
SO ./textures/wall_south.png
WE ./textures/wall_west.png
EA ./textures/wall_east.png
F 175,25,14
C 255,255,0

11111111111111111
11000000110101011
 1000001111110001
 10000000000E0001
1100000111010101
11110111 1110101
1111111 11111111
