NO ./textures/wall_north.png
SO ./textures/wall_south.png
WE ./textures/wall_west.png
EA ./textures/wall_east.png
C 0,123,222
F 175,25,14



        1111111111111111111111111
        1000000000110000000000001
        1011000001110000000000001
        1001000000000000000000001
111111111011000001110000000000001
10000000001100000111011111111111
11110111111111011100000010001
11110111111111011101010000001
11000000110101011100000010001
100  0000W000001100000010001
100  000 00000001101010010001
11000001110101011111011110001
11110111 1110101 101111010001
1111111 1111111 1111111111111
